1111111111111111111111
1E000C000000X00C000001
1010000100100000101001
10100100101010100010C1
1P0000000C00C0000X0001
1111111111111111111111
