111111111111111111111111111111
1E000C000000000C00000C00000001
101001010010000010100100000001
101001001010101000100100001C01
1P0000000C00C00000000000C00001
111111111111111111111111111111
