1111111
1C00C01
1E001P1
1111111
